#?##################
#                  #
# ################ #
# #         #  #   #
# # #### #    #   ##
# # #    ######## ##
# # #    #         #
# # #    # ### #####
#   # ##           #
##################!#
